11111111111111111111111
10000000000000000000001
10000V00000000000000001
10000000000000000000001
10000000000000000000001
1000000000000000V100001
10000000100000000000001
10000000100000000000001
10000000100000000000001
10000001000000000000001
10000010000000000000001
10000010000000000000001
100000100000000V0000001
10000100000000000000001
1000010000000000V100001
100P0100000000000000001
100001000C0000000000001
100E0100000000000000001
11111111111111111111111
