1111111111111
10010000000C1
1000011111001
1000110000V01
1P0011EV00001
1000110000001
1111111111111
