1111111111111111111
1V101V1010101V101E1
1000000000000000001
1CCCCCCCCCCCCCCCCC1
1000000000000000001
1P1V101V101V101V1V1
1111111111111111111
