1111111111111
10010000000C1
1000011100001
1000110000001
1P0011E0V1001
1000110000V01
10001100000C1
1111111111111
